111111111111111111111111111111111111111111
111111111111111111111111111111111111111111
111111111111111111111111111111111111111111
111111111111111111111111111111111111111111
111111111111111111111111111111111111111111
111111111111111111111111111111111111111111
111111111111111111111111111111111111111111
111111111111111111111111111111111111111111
111111111111111111111111111111111111111111
111111111111111111111111111111111111111111
111111111111111111111111111111111111111111
111111111111111111111111111111111111111111
111111111111111111111111111111111111111111
111111111111111111111111111111111111111111
111111111111111111111111111111111111111111
111111111111111111111111111111111111111111
111111111111111111111111111111111111111111
111111111111111111111111111111111111111111
111111111111111111111111111111111111111111
111111111111111111111111111111111111111111
111111111111111111111111111111111111111111
111111111111111111111111111111111111111111
111111111110000000000000000000000000001111
111111111110000011000000110000001100001111
111111111110001111111011111110111111101111
111111111110001111111011111110111111101111
111111111110000000000000000000000000001111
111111111110000011000000110000001100001111
111111111110001111111011111110111111101111
111111111110001111111011111110111111101111
111111111110000000000000000000000000001111
111111111110001111111111111111111111111111
111111111110001111111111111111111111111111
111110000000001111111111111111111111111111
111110000000001111111111111111111111111111
111110000000001111111111111111111111111111
111110000000001111111111111111111111111111
111110000000001111111111111111111111111111
111110000000001111111111111111111111111111
111110000000001111111111111111111111111111
111110000000001111111111111111111111111111
111110000000001111111111111111111111111111
111110000000001111111111111111111111111111
111110000000001111111111111111111111111111
111110000000001111111111111111111111111111
111110000000001111111111111111111111111111
111110000000000000000000000000000000001111
111110000000000000000000000000000000001111
111110000000000000000000000000000000001111
111110000000000000000000000000000000001111
111110000000000000000000000000000000001111
111111111011111111111111111111111111111111
111111111011111111111111111111111111111111
111111111011111111111111111111111111111111
111111111011111111111111111111111111111111
111111111011111111111111111111111111111111
111111111011111111111111111111111111111111
111111111011111111111111111111111111111111
111111111111111111111111111111111111111111
111111111111111111111111111111111111111111