1100110000000000111111111111110000000111
1111111111111111111111111111111111111111
1111111111111111111111111111111111111111
1111111111111111111111111111111111111111
1111111111111111111111111111111111111111
1111111111111111111111111111111111111111
1111111111111111111111111111111111111111
1111111111111111111111111111111111111111
1111111111111111111111111111111111111111
1111111111111111111111111111111111111111
1111111111111111101111111111111111111111
1111111111111111001111111111111111111111
1111111000000000001111111111111111111111
1111111000000000001111111111111111111111
1111111111111011111111111111111111111111
1111111111111011111111111111111111111111
1111111111111011111111111111111111111111
1111111111111011111111111111111111111111
1111111111111011111111111111111111111111
1111111111111011111111111111111111111111
1111111111110000111111111000000000111111
1111111111110000111111111000000000111111
1111111011111110001111111000111111111111
1111111011111110001111111000111111111111
1111111000111111100000000011111111111111
1111111000111111100000000011111111111111
1111111000111110000000000011111111111111
1111111000111000000000000011111111111111
1111111000000000001111111111111111111111
1111111000000000001111111111111111111111
1111111111111011111111111111111111111111
1111111111111011111111111111111111111111
1111111111111011111111111111111111111111
1111111111111011111111111111111111111111
1111111111111011111111111111111111111111
1111111111111011111111111111111111111111
1111111111111011111111111111111111111111
1111111111111011111111111111111111111111
1111111111111111111111111111111111111111
1111111111111111111111111111111111111111