1111111111111111111111111111111111111111111111111111111111111111111111111111111111111111111111111111
1111111111111111111111111111111111111111111111111111111111111111111111111111111111111111111111111111
1111111111111111111111111111111111111111111111111111111111111111111111111111111111111111111111111111
1111111111111111111111111111111111111111111111111111111111111111111111111111111111111111111111111111
1111111111111111111111111111111111111111111111111111111111111111111111111111111111111111111111111111
1111111111111111111111111111111111111111111111111111111111111111111111111111111111111111111111111111
1111111111111111111111111111111111111111111111111111111111111111111111111111111111111111111111111111
1111111111111111111111111111111111111111111111111111111111111111111111111111111111111111111111111111
1111111111111111111111111111111111111111111111111111111111111111111111111111111111111111111111111111
1111111111111111111111111111111111111111111111111111111111111111111111111111111111111111111111111111
1111111111111111101111111111111111111111111111111111111111111111111111111110001111111111111111111111
1111111111111111101111111111111111111111111111111111111111111111111111111110001111111111111111111111
1111111111111110000000111111111111111111111111111111111111111111111111111000000011111111111111111111
1111111111111110000000111111111111111111111111111111111111111111111111111000000011111111111111111111
1111111111111000000000000000110011111111111111111111111111111111100000000000000000001111111111111111
1111111111111000000000000000110011111111111111111111111111111111100000000000000000001111111111111111
1111111111100000000000000000000000000011111000000000001111111000000000000000000000001111111111111111
1111111111100000000000000000000000000011111000000000001111111000000000000000000000001111111111111111
1111111111100000000000000000000000000000000000000000000000111000000000000000000000000011111111111111
1111111111100000000000000000000000000000000000000000000000111000000000000000000000000011111111111111
1111111111111000000000000000000000000000000000000000000000111000000000000000000000000011111111111111
1111111111111100000000000000000000000000000000000000000000111000000000000000000000110011111111111111
1111111111111100000000000000000000000000000000000000000000000000000000000000000000111011111111111111
1111111111111100000000000000000000000000000000000000000000000000000000110000110011111111111111111111
1111111111111110000000000000000000000000000000000000000000000000000000111000111011111111111111111111
1111111111111111000000000000000000000000000000000000000000000000000000111000111111111111111111111111
1111111111111111100000000000000000000000000000000000000000000000000000111000111111101111111111111111
1111111111111111111111000000000000000000000000000000000000000000000000111000111111101111111111111111
1111111111111111111111100000000000000000000000000000000000000000000000000000001110001111111111111111
1111111111111111111111100000000000000000000000000000000000000000000000000000001111111111111111111111
1111111111111111111111100000000000000000000000000000000000000000000000000000000011111111111111111111
1111111111111111111111100000000000000000000000000000000011110000000000000000000011111111111111111111
1111111111111111111111100000000000000000000000000000000011110000000000000000000011111111111111111111
1111111111111111111111100000000000000000000000001111111111111000000000000000000011111111111111111111
1111111111111111111000000000000000000000000000001111111111111110000000000000000011111111111111111111
1111111111111111111000000000000000000000000000111111111111111110000000000000000011111111111111111111
1111111111111111111000000000000000000000000000111111111111111111100000000000000000111111111111111111
1111111111111111111000000000000011000000000000111111111111111111100000000000000000111111111111111111
1111111111111111111000000000000011100000000000111111111111111111100000000000000000111111111111111111
1111111111111111111000000000000011100000000000111111111111111111100000000000000011111111111111111111
1111111111111111111000000000000011100000000000001111111111111111100000000000000011111111111111111111
1111111111111111111000000000001111100000000000001111111111111111100000000000000011111111111111111111
1111111111111111111000000000001110000000000000001111111111111111100000000000000011111111111111111111
1111111111111111111000000000001111000000000000001111111111111111100000000000000011111111111111111111
1111111111111111111000000000111111100000000000001111111111111111100000000000000011111111111110111111
1111111111111111111000000000111111100000000000001111111111111111100000000000000011111111111110111111
1111111111111111100000000000111111100000000000000000111111111110000000000000000011111111100000001111
1111111111111111100000000000111111100000000000000000111111111110000000000000000011111111100000111111
1111111111111000000000000000111111100000000000000000001111111110000000000000000011111110000000111111
1111111111111000000000000000111111100000000000000000001111111110000000000000000011111110001111111111
1111111111111000000000000000111110000000000000000000000011111000000000000000000000111000001111111111
1111111111111000000000000000111110000000000000000000000011111000000000000000000000111000111111111111
1111111111111000000000000000000000000000000000000000000000111000000000000000000000000000111111111111
1111111111011000000000000000000000000000000000000000000000111000000000000000000000000011111111111111
1111111111000000000000000000000000000000000000000000000000000000000000000000000000000011111111111111
1111111111110000000000000000000000000000000000000000000000000000000000000000000000000011111111111111
1111111111111000000000000000000000000000000000000000000000000000000000000000000000000011111111111111
1111111111111111000000000000000000000000000000000000000000000000000011000000000000001111111111111111
1111111111111111000000000000000000000000000000000000000000000000000011000000000000001111111111111111
1111111111111111110000111111110000000000000000000000000000000000001111100000001111111111111111111111
1111111111111111110000111111111000000000000000000000000000000000001111100000001111111111111111111111
1111111111111111111000111111111000000000000000000000000000000000001111110011001111111111111111111111
1111111111111111111000111111111000000000000000000000000000000000001111111011101111111111111111111111
1111111111111111111000111111111000000000000000000000000000000000001111111011101111111111111111111111
1111111111111111111000111111111000000000000000000000000000000000001111111011101111111111111111111111
1111111111111111111000111111111000000000000000000000000000000000111111111011111111111111111111111111
1111111111111111111000001111111000000000000000000000000000000000111111100000111111111111111111111111
1111111111111111111000001111111000000000000000000000000000000000111111110011111111111111111111111111
1111111111111111100000000000111110000000000000000000000000000000111111111011111111111111111111111111
1111111111111111100011000000111111000000000000000000000000000011111111111011111111111111111111111111
1111111111111110000011100000111111100000000000000000000000000011111111111011111111111111111111111111
1111111111110110000011100000111111100000000000000000000000001111111111111011111111111111111111111111
1111111111110011000011100000111111100000000000000000000000001111111111111000000011111111111111111111
1111111111110011100011100000111111100000000000000000000000111111111111111000000011111111111111111111
1111111111110011100000000000001111100000000000000000000000111111111111111000000011111111111111111111
1111111111111111100000000000111111110000000000000000001111111111111111111000000011111111111111111111
1111111111111110001111110000111111110000000000000000001111111111111111111000000011111111111111111111
1111111111111111001111110011111111111000000000000011111111111111111111111000000011111111111111111111
1111111111111111111111111111111111111000000000000011111111111111111111111000000000001111111111111111
1111111111111111111111111111111111111100000000111111111111111111111111111000000000001111111111111111
1111111111111111111111111111111111111110000000111111111111111111111111100000000000001111111111111111
1111111111111111111111111111111111111110001111111111111111111111111111100000001111101111111111111111
1111111111111111111111111111111111111110001111111111111111111111111110000000001111101111111111111111
1111111111111111111111111111111111111110001111111111111111111111111110000000001111101111111111111111
1111111111111111111111111111111111111111111111111111111111111111111000000000001111111111111111111111
1111111111111111111111111111111111111111111111111111111111111111111000000000001111111111111111111111
1111111111111111111111111111111111111111111111111111111111111111111000000000001111111111111111111111
1111111111111111111111111111111111111111111111111111111111111111111100000000001111111111111111111111
1111111111111111111111111111111111111111111111111111111111111111111110000000001111111111111111111111
1111111111111111111111111111111111111111111111111111111111111111111110000000001111111111111111111111
1111111111111111111111111111111111111111111111111111111111111111111110000000001111111111111111111111
1111111111111111111111111111111111111111111111111111111111111111111110000000001111111111111111111111
1111111111111111111111111111111111111111111111111111111111111111111110000000001111111111111111111111
1111111111111111111111111111111111111111111111111111111111111111111111000011111111111111111111111111
1111111111111111111111111111111111111111111111111111111111111111111111000011111111111111111111111111
1111111111111111111111111111111111111111111111111111111111111111111111111111111111111111111111111111
1111111111111111111111111111111111111111111111111111111111111111111111111111111111111111111111111111
1111111111111111111111111111111111111111111111111111111111111111111111111111111111111111111111111111
1111111111111111111111111111111111111111111111111111111111111111111111111111111111111111111111111111
1111111111111111111111111111111111111111111111111111111111111111111111111111111111111111111111111111