111111111111111111111111111111111111111111100000111111111111111111111111
111111111111111111111111111111111111111111100000111111111111111111111111
111111111111111111111111111111111111111111100000111111111111111111111111
111111111111111111111111111111111111111111100000111111111111111111111111
111111111111111111111111111111111111111111100000111111111111111111111111
111111111111111111111111111111111111111111100000111111111111111111111111
111110000000000000000000000000000000001110000000000000000000111111111111
111110001111111111000000000000000000001110000000000000000000111111111111
111110001111111111100011000000000000001110000000000000000000110000001111
111110111111111111110011001111111100001110000000000000000000110000001111
111110111111111111111011001111111110000011110011111111111100111110111111
111110111111111111111011111111111111110011110011111111111100111110111111
111110111111111111111011111111111111111011000011111111111100110000001111
111110111111111111111011111111111111111011000011111111111100110000001111
111110111111111111111011111111111111111011000011111111111100111110111111
111110111111111111111011111111111111111111000011111111111100111110111111
111110111111111111111011111111111111111111000011101111111100110000001111
111110111111111111111011111111111111111111000011101111111100110000001111
111110001111101111100011111111111111111111000000000000001100111111101111
111110001111101111100011111111111111111111000000000000001100111111101111
111110000000000000000011111111111111111111111111111111111100000000001111
111111111111001111111111111111111111111111111111111111111100111111111111
111111111111101111111111111111111111111111111111111111111110111111111111
111111111111101111111111111111111111111111111111111111111110111111111111
111110000000000011111111101111111111001111111000000000000000000000001111
111111000000000011111111101111111111001111111000000000000000111111001111
111111000000000011111111100000111111001111111000000000000000111111101111
111111111111000011111111100000111111001111111000111111111000111111101111
111110111111100011101111100000111100001110111000111111111000111111101111
111110000001100011101111100011111111001110111000111111111000111111101111
111110000001100000000000000011111111100000000000111111111000111111101111
111110110001100000000011001111111111110000000000111111111000111111101111
111110111000000000000011101111111111111000000000111111111000000000001111
111110111011000000000011101111111111111111110011111111111000000000001111
111110000011100000000011101111111111111111111011111111111000000000001111
111110111111100000000011101111111111111111111011111111111100111100001111
111110111111100000000011101111111111111000000000001111111110111110001111
111111111111100000000011101111111111111000000000001111111110111111111111
111111100000000000000011100011111111100000000000000000000000001111111111
111111100000111111000011100011111111100000000000111111000000001111111111
111110000000111111100000000000000000000000000000111111100000000000001111
111110000000111111100000001111000000110000000011111111110000000000001111
111110001111111111100000001111100000111000000011111111110000000000001111
111110001111111111100000001111100000111000001111111111111100000000001111
111110001111111011100000000000000000000000001111111111111110000000001111
111110001111111011100000000000000000000000001111111111111110000000001111
111110001111100000000000000000000000000000001111111011111110000000001111
111110001111100000000011111100000000000000001111111011111110000000001111
111110000000000000000011111100000000000000000000000000000000000000001111
111110000011111111000011111111111111111000001111111100000000000000001111
111110000011111111100011111111111111111000001111111110000000000000001111
111110000011111111100011111111111111111000001111111110000000000000111111
111110000011111111100011101111111111111000001111111110000000000000111111
111110000011111111100011101111111111111000001100111110000000000011111111
111110000011111111100000000011111111111000001110111110000000000011111111
111110110011111111100000000011111111111000001110111110111111000011111111
111110110000000000000000000011111011111000000000000000111111100011001111
111110111000000000000000000011111011111000000000000000111111100011001111
111110111000000000000000000000000000000000000000000000111111100000001111
111110111000001100000000000000000000000000000000000000111111101111001111
111110000000001110000000000000000000000000000000000000111111101111101111
111110000000001110110000000000000000000000000000000000111111101111101111
111110000000001110111000000000000000000000000000000000111111101110001111
111110000000001110111000000000000000000000000000000000111111101110001111
111110000000000000111000000000000000000000000000000000000000000000001111
111111111111111111111111111111000000111111111111111111111111111111111111
111111111111111111111111111111100000111111111111111111111111111111111111
111111111111111111111111111111100000111111111111111111111111111111111111
111111111111111111111111111111100000111111111111111111111111111111111111
111111111111111111111111111111100000111111111111111111111111111111111111
111111111111111111111111111111100000111111111111111111111111111111111111
111111111111111111111111111111100000111111111111111111111111111111111111