1111111111111111111111111111111111111111111111111111111111111111
1111111111111111111111111111111111111111111111111111111111111111
1111111111111111111111111111111111111111111111111111111111111111
1111111111111111111111111111111111111111111111111111111111111111
1111111111111111111111111111111111111111111111111111111111111111
1111111111111111111111111111111111111111111111111111111111111111
1111111111111111111111111111111111111111111111111111111111111111
1111111111111111111111111111111111111111111111111111111111111111
1111111111111111111111111110000000000011111111111111111111111111
1111111111111111111111111110000000000011111111111111111111111111
1111111111111111111111111110000000000011111111111111111111111111
1111111111111111111111111110000000000011111111111111111111111111
1111111111111111111111111110000000000011111111111111111111111111
1111111111111111111111111110000000000011111111111111111111111111
1111111111111111111111111110000000000011111111111111111111111111
1111111111111111111111111110000000000011111111111111111111111111
1111111111111111111111111110000000000011111111111111111111111111
1111111111111111111111111110000000000011111111111111111111111111
1111111111111111111111111110000000000011111111111111111111111111
1111111111111111111111111110000000000011111111111111111111111111
1111111111111111111111111110000000000011111111111111111111111111
1111111111111111111111111110000000000011111111111111111111111111
1111111111111111111111111110000000000011111111111111111111111111
1111111111111111111111111110000000000011111111111111111111111111
1111111111111111111111111110000000000011111111111111111111111111
1111111111111111111111111110000000000011111111111111111111111111
1111111111111111111111111110000000000011111111111111111111111111
1111111111111111111111111110000000000011111111111111111111111111
1111111111111111111111111110000000000011111111111111111111111111
1111111111111111111111111110000000000011111111111111111111111111
1111111111111111111111111110000000000011111111111111111111111111
1111111111111111111111111110000000000011111111111111111111111111
1111100000111111111111111110000000000011111111111111111000001111
1111100000111111111111111110000000000011111111111111111000001111
1111100000000000000000000000000000000000000000000000000000001111
1111100011111111111111110000000000000000111111111111111100001111
1111100011111111111111111000000000000000111111111111111110001111
1111110011111111111111111000000000000000111111111111111110001111
1111110011111111111111111000000000000000111111111111111110111111
1111111011111111111111111000000000000000111111111111111110111111
1111111011111111111111111000000000000000111111111111111110111111
1111111011111111111111111000000000000000111111111111111110111111
1111111011111111111111111000000000000000111111111111111110111111
1111111011111111111111111000111111110000111110001111111110111111
1111111011111111111111111000111111111000111111111111111110111111
1111111011111111111111111000111111111000111111111111111110111111
1111111011111111111111111000111111111000111111111111111110111111
1111111011111111111111111000111111111000111111111111111110111111
1111111011111111111111111000111111111000111111111111111110111111
1111111011111111111111111000111111111000111111111111111110111111
1111111011111111111111111000111111111000111111111111111110111111
1111111011111111111111111000111111111000111111111111111110111111
1111111011111111111111111000111111111000111111111111111110111111
1111111011111111111111111000111111111000111111111111111110111111
1111111011111111111111111000111111111000111111111111111110111111
1111111011111111111111111000111111111000111111111111111110111111
1111111000000000000000000000000000000000000000000000000000111111
1111111011111111111111111111110000111111111111111111111100111111
1111111011111111111111111111111000111111111111111111111110111111
1111111011111111111111111111111000111111111111111111111110111111
1111111011111111111111111111111000111111111111111111111110111111
1111111011111111111111111111111000111111111111111111111110111111
1111111011111111111111111111111000111111111111111111111110111111
1111111011111111111111111111111000111111111111111111111110111111
1111111011111111111111111110000000000011111111111111111110111111
1111111011111111111111111110000000000011111111111111111110111111
1111111011111111111111111110000000000011111111111111111110111111
1111111011111111111111111110000000000011111111111111111110111111
1111111011111111111111111110000000000011111111111111111110111111
1111111011111111111111111110000000000011111111111111111110111111
1111111011111111111111111110000000000011111111111111111110111111
1111111011111111111111111110000000000011111111111111111110111111
1111111011111111111111111110000000000011111111111111111110111111
1111111011111111111111111111000000001111111111111111111110111111
1111111011111111111111111111100000001111111111111111111110111111
1111111011111111111111111111100000001111111111111111111110111111
1111100011111111111111111111100000001111111111111111111110001111
1111100011111111111111111111100000001111111111111111111110001111
1111100000000000000000000000000000000000000000000000000000001111
1111100000000000000000000000000000000000000000000000000000001111
1111100000111111111111111111111111111111111111111111110000001111
1111100000111111111111111111111111111111111111111111110000001111
1111111111111111111111111111111111111111111111111111111111111111
1111111111111111111111111111111111111111111111111111111111111111
1111111111111111111111111111111111111111111111111111111111111111
1111111111111111111111111111111111111111111111111111111111111111
1111111111111111111111111111111111111111111111111111111111111111
1111111111111111111111111111111111111111111111111111111111111111
1111111111111111111111111111111111111111111111111111111111111111
1111111111111111111111111111111111111111111111111111111111111111