111111111111111000001111111111111111111111111111111111111111111111111111111111111111111111111111
111111111111111000001111111111111111111111111111111111111111111111111111111111111111111111111111
111111111111111000001111111111111111111111111111111111111111111111111111111111111111111111111111
111111111111111000001111111111111111111111111111111111111111111111111111111111111111111111111111
111111111111111000001111111111111111111111111111111111111111111111111111111111111111111111111111
111111111111111000001111111111111111111111111111111111111111111111111111111111111111111111111111
111111111111111000001111111111111111111111111111111111111111111111111111111111111111111111111111
111111111111111000001111111111111111111111111111111111111111111111111111111111111111111111111111
111111111111111000000000111111111111111111111111111111111111111111111111111111111111111111111111
111111111111111000000000111111111111111111111111111111111111111111111111111111111111111111111111
111111111110000000000000000000110011111111111111111111111111111111111111111111111111111111111111
111111111110000000000000000000111011111111111111111111111111111111111111111111111111111111111111
111111111000000000000000000000111000000000111111111111111000111111111111111111111111111111111111
111111111000000000000000000000111000000000111111111111111000111111111111111111111111111111111111
111111111000000000000000000000000000000000111111100000000000000000111110111111111111111111111111
111111111000001100000000000000000000001111111111100000000000000000111110111111111111111111111111
111111111000001110000000000000000000001111000000000000000000000000000000000000001111111111111111
111111111000001110000000000000000000001111100000000000000000000000000000001111111111111111111111
111111100000001110000000000000000000001111100000000000000000000000000000001111111111111111111111
111111100000001110000000000000000000001111100000000000000000000000000011111111111111111111111111
111110000000000000000000000000000000000000000000000000000000000000000011111111111111111111111111
111110000000000000111111111111000000000000000000000000001100000000001111111111111111111111111111
111110000000000000111111111111000000000000000000000000001110000000001111111111100000111111111111
111110001100000000111111111111100000000000000000000000001110001111111111111111100011111111111111
111110001110000000111111111111100000000000000000000000001110001111111111111011100011111111111111
111110001110000000111111111111100000000000000000000000001110111111111111111011100011111111111111
111110001110000000111111111111100000000000000000000000000000111111111111100000000011111111111111
111110001110000000111111111111100000000000000000000000000011111111111111100000110011111111111111
111110000000000000111111111111100000000000000000000000000011111110000000000000111011111111111111
111110000000000000111111111111100000000000000000000000001111111110000000000000111011111111111111
111110000000000000111111111111100000000000000000000000001111111110000000000000000011111111111111
111110000000000000111111111111100000110000000000000000001111111110000000000000000011111111111111
111110000000000000111111111111100000111000000000000000001111111000000000000000000011111111111111
111110000000000000111111111111100000111000000000000000001111111000000000111100000011111111111111
111110000000000000000000000000000000111000000000000000001111100000000000111110000011111111111111
111110000000000000000000000000000000111000000000000000001111100000000000111110000011111111111111
111110000000000000000000000000000000000000000000000000000000000000000000111110000000111111111111
111110110000000000000000000000000000111100000000000000001111000000000000111110000000111111111111
111110111000000000000000000000000000111100000000000000001111100000000000000000000000111111111111
111110111000000000000011111111000011111111000000000000001111100000000000000000000000111111111111
111110111000000000000011111111000011111111100000000000001111100000000000000000000000111111111111
111110111000000000000011111111100011111111110000110000001111100000000000000000000000111111111111
111111100000000000000011111111100011111111111000111000001111100000000000000000000000000000001111
111111100000000000000011111111100011111111111000111000001111100000000000000000000000000000001111
111111100000000000000011111111100011111111111000111000001111100000000000000000000000000000001111
111111100000111100000011111111100011111111111000111000001111100000000000000000000000001111111111
111111111000111110000000000000000011111111111000000000001111100000000000000000000000001111111111
111111111111111111000000000000000011111111111000000000111111100000000000000000000011111111111111
111111111111111111000000000000000011111111000000000000111111100000000000000000000011111111111111
111111111111111111110000000000000011111111000000000011111111100000000000000000001111111111111111
111111111111111111111000000000000000000000000000000011111111100000000000000000001111111111111111
111111111111111111111000000000000000000000111111111111111111100000000000000000111111111111111111
111111111111111111111000000000000000000000111111111111111110000000000000000000111111111111111111
111111111111111111111000000000000000000011111111111111111110111100000000000000111111111111111111
111111111111111111111000000000000000000011111111111111111000111110000000000000111111111111111111
111111111111111111111000000000000000000011111111111111111000111110000000000000111111111111111111
111111111111100011111000000000000000000011111110111110000000111110000000000000111111111111111111
111111111111100011111000000000000000001111111110111110000000111110000000000000111111111111111111
111111111011100000111000000000000000001111110000000000000000000000000000000000111111111111111111
111111111011100000111000000000000000001111111100000000000000001100000000000000111111111111111111
111111100000000000000000000000000000001111111110000000000000001110000000000000111111111111111111
111111100000000000000000000000111100111111111110000000000000001110000000000000111111111111111111
111111100000000000000000000000111110111111100000000000000000000000000000000000111111111111111111
111111100000000000000000000011111110111111101100000000000000000000000000000000111111111111111111
111111100000000000000000000011111110111111101100000000000000000000000000000000001111111111111111
111111100000000000000000001111111110111111101111000000000000000000000000000000001111111111111111
111111100000000000000000001111111110000000001111100000000000000000000000000000001111111111111111
111111100000000000000000111111111110000000001111100001111111000000000000000000001111111111111111
111111100000000000000000111111111000000000000011100001111111100000000000000000001111111111111111
111111100000000000000000111111111000000000000011100011111111100000000000000000001111111111111111
111110000000000000000000111111100000000000000000000011111111100000000000000000001111111111111111
111110000011000000000011111111100000000000000000001111111111100000000000000000001111111111111111
111110000011100000000011111110000000000000000000001111111111100000000000000000000000111111111111
111110000011100000000011111110000000000000000000001111111111100000000000000000000000111111111111
000000000000000000000011111110000000000000000000001111111111100000000000000000000000000000001111
000000000000000000000011111110000000000000000000001111111111100000000000000000000000000000001111
000000000000000000000011111100000000000000000000001111111110000000000000000000000000000000001111
111100001100000000000011110000000000000000000011001111111110110000000000000000111100000000001111
111110001110000000000000000000000000000000000011101111111000111000000000000000111110000000001111
111110001110000000000011111000000000000000000011101111111000111000000000000000111110000000111111
111111101110000000000011111000000000000000000011100000000000111000000000000000111110000000111111
111111101110000000111111111011000000000000000011100000000000111000001100000000111110000011111111
111111111000000000111111111011100000000000000000000000000000000000001100000000000000000011111111
111111111000000000111111111011100000000000000000000000000000000000111110000000000011111111111111
111111111110000000111111111011100000000000000000000000000000000000111110000000000011111111111111
111111111110000000111111111011100000000000001100000000000000000000111110000000001111111111111111
111111111111100000001111111000000000000000001110000000000000000000111000000000001111111111111111
111111111111100000001111111000000011111111001110000000000000000000111011111111111111111111111111
111111111111111000001111000000000011111111101110000000000000000000000011111111111111111111111111
111111111111111100001111000011111111111111111111110000000000001111111111111111111111111111111111
111111111111111110001111000011111111111111111111111000000000001111111111111111111111111111111111
111111111111111111111111111111111111111111111111111111111111111111111111111111111111111111111111
111111111111111111111111111111111111111111111111111111111111111111111111111111111111111111111111
111111111111111111111111111111111111111111111111111111111111111111111111111111111111111111111111
111111111111111111111111111111111111111111111111111111111111111111111111111111111111111111111111
111111111111111111111111111111111111111111111111111111111111111111111111111111111111111111111111