1111111111111111111111111111111111111111
1111111111111111111111111111111111111111
1111111111111111111111111111111111111111
1111111111111111111111111111111111111111
1111111111111111111111111111111111111111
1111111111111111111111111111111111111111
1111111111111111111111111111111111111111
1111111111111111111111111111111111111111
1111111111111011111111111111111111111111
1111111111111011111111111111111111111111
1111111000000011111111111011111111111111
1111111000000011111111111011111111111111
1111111000000000000011111000000011111111
1111111000000000000011111000000011111111
1111111111111110111111111111101111111111
1111111111111110111111111111101111111111
1111111111111110111111111111101111111111
1111111111111110111111111111101111111111
1111111111111110111111111111101111111111
1111111111111110111111111111101111111111
1111111111111110111000000000000011111111
1111111111111110111000000000000011111111
1111111111111110000011111111101111111111
1111111111111110000011111111101111111111
1111111111111110111111111111101111111111
1111111111111110111111111111101111111111
1111111110000000111111111111101111111111
1111111110000000001111111111101111111111
1111111000000000000000111111101111111111
1111111000000000000000111111101111111111
1111111111101111111111111110001110111111
1111111111101111111111111110001110111111
1111111111101111111111111110000000111111
1111111111101111111111111110000000111111
1111111111101111111111111111111111111111
1111111111101111111111111111111111111111
1111111111101111111111111111111111111111
1111111111101111111111111111111111111111
1111111111111111111111111111111111111111
1111111111111111111111111111111111111111