111111111111111111111111111111111111111111111111111111111111111111111111111111111111111111111111
111111111111111111111111111111111111111111111111111111111111111111111111111111111111111111111111
111111111111111111111111111111111111111111111111111111111111111111111111111111111111111111111111
111111111111111111111111111111111111111111111111111111111111111111111111111111111111111111111111
111111111111111111111111111111111111111111111111111111111111111111111111111111111111111111111111
111111111111111111111111111111111111111111111111111111111111111111111111111111111111111111111111
111111111111111000000000111111111111111111111111111111111111111111111111111111111111111111111111
111111111111111011111111111111111111111111111111111111111111111111111111111111111111111111111111
111111111111100011111111000011111111111111111111111111111111111111111111111111111111100011111111
111111111111100011111111001111111111111111111111111111111111111111111111111111111111100011111111
111111111111101111111111001111111111111111111111111111111111111111111111111111111111100011111111
111111111111101111111111001111111111111111111111111111111111111111111111111111111111100011111111
111111111111101111110011000011111111111111111111111111111111100011111111111000000000001111111111
111111111111101111110011001111111111111111111111111111111111100011111111111000000000001111111111
111111111111100000000000001111111111111111111111111111111111100000111111100000000000111111111111
111111111111100000000000111111111111111111111111111111111111100000111111100000000000111111111111
111111111111111000000000111111111111111111111111111111111111100000000000000000000011111111111111
111111111111111000000011111111111111111111111111111111111111100000111111110000000011111111111111
111111111111111110000011111111111111111111111111111111111111100000111111111000000011111111111111
111111111111111110000011111111111111111111111111111111111111100011111111111100000011111111111111
111111111111111110000011111111111111111111111111111111111111100011111111111110001111111111111111
111111111111111110001111111111111111111111111111111111111111111111111111111111101111111111111111
111111111111111110001111111111111111111111111111111111111111111111110000111111101111111111111111
111111111111111110001111111111111111111111111111111111111111111111110000111111101111111111111111
111111111111111000001111111111111111111111100000111111111111111111000000001111101111111111111111
111111111111111000111111111111111111111111100000111111111111111111000000001111101111111111111111
111111111111111000111111111111111111111110000000111111111110000000000000001111101111111111111111
111111111111111011111111111111111111111110000000111111111110000000000000001111101111111111111111
111111111111100011111111111111111110000000000000111111111110000000000000111111100011111111111111
111111111111100011111111111111111110000000000000111111111110000000000000111111100011111111111111
111111111111100011111111111111100000000000000000111111111110000000000011111110000000111111111111
111111111111100011111111111111100011110000001111111111111110000000000011111110000000111111111111
111111111110000011111111111110000011111000001111111111111110000000000011100000000000001111111111
111111111110110011111111111110111111111000001111111111111110000000000011100000000000001111111111
111111111110111000111111111000111111111000001111111111111110000000000011100000000000001111111111
111111111111111000111111111011111111111000111111111111111110000000000011111000110000001111111111
111111111111111000000000000011111111111000111111111111111111000000000011111000111000001111111111
111111111111111000001111111111111111111000111111111111111111000000000011111000111000111111111111
111111111111100000001111111111111111111000111111111111111111110000111111111000000000111111111111
111111111111100000111111111111111111111000111111111111111111110000111111111000000000111111111111
111111111111100000111111111111111111111000111111111111111111111100001111111000000000111111111111
111111111111100011111111111111111111111011111111111111111111111100001111111000000000111111111111
111111111110000011111111111111111111111011111111111111111111111100001111111000000000111111111111
111111111110001111111111111111111111111111111111111111111111111100001111111100000011111111111111
111111111110001111111111111111111111111111111111111111111111111100001111111110000011111111111111
111111111110001111111111111111111111111111111111111111111111111100001111111110000011111111111111
111111111000000011111111111111111111111111111111111111111111111100111111111111100011111111111111
111111111000000011111111111111111111111111111111111111111111111111111111111111100011111111111111
111111111000000011111111111111111111111111111111111111111111100011111111111111100011111111111111
111111111000000011111111111111111111111111111111111111111111101111111111111111100011111111111111
111111111000000011111111111111111111111111111111111111111110001111111111111111100011111111111111
111111111000001111111111111111111111111111111111111111111110001111111111111111100011111111111111
111111111000001111111111111111111111111111111111111111111000001111111111111110000000001111111111
111111111000001111111111111111111111111111111111111111111000111111111111111110000000111111111111
111111111000001111111111111111111111111011111111111111100000111111111111111000000000111111111111
111111111000001111111111111111111111111011111111111111100000111111111111111000000011111111111111
111111111000001111111111111111111111100011111111100000000000001111111111100000000011111111111111
111111111000001111111111111111111111100011111111100000000000001111111111100000001111111111111111
111111111100000011111111111111111000000011111111100000000000000011111000000000001111111111111111
111111111111000011111111111111111000000011111111100000000000000011111000000000111111111111111111
111111111111100000000011111110000000000000000000000000000000000000000000000000111111111111111111
111111111111100000000011111110001111111111111111000000000000000000000011111111111111111111111111
111111111111111000000011100000001111111111111111111100000000000000000011111111111111111111111111
111111111111111000000011100000001111111111111111111100000000000000000011111111111111111111111111
111111111111111110000000000000001111111111111111111111111000000000001111111111111111111111111111
111111111111111110000000111100001111111111111111111111111000000000001111111111111111111111111111
111111111111111110000000111110000011111111111111111111111000000000001111111111111111111111111111
111111111111111110000011111111000011111111111111111111111000000000001111111111111111111111111111
111111111111111110000011111111100000111111111111111111111000000000001111111111111111111111111111
111111111111111110000011111111110000111111111111111111111000000000001111111111111111111111111111
111111111111111110000011111111111000001111111111111111111000001110001111111111111000001111111111
111111111111111110000011111111111100001111111111111111111000001111001111111111111000001111111111
111111111111111000000011111111111110001111111111111111111000111111100011111111100000001111111111
111111111111111000000011111111111110001111111111111111111000111111110011111111100000001111111111
111111111111111000000011111111111110001111111111111111100011111111111000000000000000000000111111
111111111111111000000011111111111110111111111111111111100011111111111111110011111111000000111111
111111111111100000000011111111111110111111111111111111100011111111111111111011111111100000111111
111111111111100000000011111111111110111111111111111111100011111111111111111011111111111111111111
111111111111100000000011101111111000001111111110000000000011111111111111111111111111111111111111
111111111111100000001111101111111000111111111110000000000011111111111111111111111111111111111111
111111111110000000001111100000000000111111111111100000000011111111111111111111111111111111111111
111111111110000000001111100000000011111111111111100000000011111111111111111111111111111111111111
111111111110000000001111100000000011111111111111111000000011111111111111111111111111111111111111
111111111111000000001111111111111111111111111111111000000011111111111111111111111111111111111111
111111111111100000001111111111111111111111111111111000000011111111111111111111111111111111111111
111111111111100000111111111111111111111111111111111111111111111111111111111111111111111111111111
111111111111100000111111111111111111111111111111111111111111111111111111111111111111111111111111
111111111111100000111111111111111111111111111111111111111111111111111111111111111111111111111111
111111111111100000111111111111111111111111111111111111111111111111111111111111111111111111111111
111111111111110011111111111111111111111111111111111111111111111111111111111111111111111111111110
111111111111111011111111111111111111111111111111111111111111111111111111111111111111111111111111
111111111111111011111111111111111111111111111111111111111111111111111111111111111111111111111111
111111111111111011111111111111111111111111111111111111111111111111111111111111111111111111111111
111111111111111011111111111111111111111111111111111111111111111111111111111111111111111111111111
111111111111111011111111111111111111111111111111111111111111111111111111111111111111111111111111
111111111111111011111111111111111111111111111111111111111111111111111111111111111111111111111111