1111111111111111111111111111111111111111111111111111111111111111
1111111111111111111111111111111111111111111111111111111111111111
1111111111111111111111111111111111111111111111111111111111111111
1111111111111111111111111111111111111111111111111111111111111111
1111111111111111111111111111111111111111111111111111111111111111
1111111111111111111111111111111111111111111111111111111111111111
1111111111111111111111111111111111111111111111111111111111111111
1111111111111111111111111111111111111111111111111111111111111111
1111111111111111111111111111111111111111111111111111111111111111
1111111111111111111111111111111111111111111111111111111111111111
1111111111111111111111111111111111111111111111111111111111111111
1111111111111111111111111111111111111111111111111111111111111111
1111111111111111111011111111111000111111111110111111111111111111
1111111111111111111011111111111000111111111110111111111111111111
1111111111111111100011111111111000111111111110001111111111111111
1111111111111111100011111111111000111111111110001111111111111111
1111111111111111100011111111111000111111111110001111111111111111
1111111111111111110011111111111000111111111110111111111111111111
1111111111111111111000111111000000001111111000111111111111111111
1111111111111111111000111111000000001111111000111111111111111111
1111111111111111111000001110000000000011100000111111111111111111
1111111111111111111000000000111111110000000000111111111111111111
1111111111111111111000000000111111111000000000001111111111111111
1111111111111111111000111111111111111111110000111111111111111111
1111111111111111111000111111111111111111111000111111111111111111
1111111111111111111011111111111111111111111100111111111111111111
1111111111111111100011111111111111111111111110111111111111111111
1111111111111111100011111111111111111111111110111111111111111111
1111111111111111100011111111111111111111111110111111111111111111
1111111111111111110011111111111111111111111110111111111111111111
1111111111111111111011111111111111111111111110111111111111111111
1111111111111111111011111111111111111111111110111111111111111111
1111111111111111111011111111111111111111111110111111111111111111
1111111111111111111011111111111111111111111110111111111111111111
1111111111111111100000001110111111111011100000001111111111111111
1111111111111111101100000000111111111000000011001111111111111111
1111111111111111100010000000000000000000000100001111111111111111
1111111111111111110010001100000000000011000100111111111111111111
1111111111111111111000001110000000000011100001111111111111111111
1111111111111111111111111111110000011111111111111111111111111111
1111111111111111111111111111111000111111111111111111111111111111
1111111111111111111111111111111000111111111111111111111111111111
1111111111111111111111111111111000111111111111111111111111111111
1111111111111111111111111111111000111111111111111111111111111111
1111111111111111111111111111111000111111111111111111111111111111
1111111111111111111111111111111000111111111111111111111111111111
1111111111111111111111111111111000111111111111111111111111111111
1111111111111111111111111111111000111111111111111111111111111111
1111111111111111111111111111100000001111111111111111111111111111
1111111111111111111111111111110000111111111111111111111111111111
1111111111111111111111111111111000111111111111111111111111111111
1111111111111111111111111111111000111111111111111111111111111111
1111111111111111111111111111100000001111111111111111111111111111
1111111111111111111111111111100000001111111111111111111111111111
1111111111111111111111111111100000001111111111111111111111111111
1111111111111111111111111111100000001111111111111111111111111111
1111111111111111111111111111100000001111111111111111111111111111
1111111111111111111111111111100000001111111111111111111111111111
1111111111111111111111111111100000000000000000000000000000000000
1111111111111111111111111111100000000000000000000000000000000000
1111111111111111111111111111100000000000000000000000000000000000
1111111111111111111111111111111111111111111111111111111111111111
1111111111111111111111111111111111111111111111111111111111111111
1111111111111111111111111111111111111111111111111111111111111111